-----------------------------------------------------------------------------------------------------------------------------------------------------------------------------------------------------------
-----------------------------------------------------------------------------------------------------------------------------------------------------------------------------------------------------------
-----------------------------------------------------------------------------------------------------------------------------------------------------------------------------------------------------------
-------------------------------------------------------------------------------------------------------------------------------------------------------------------------------------------------------F---
-----------------------------------------------------------------------------------G-------------------------------------------------------------------------------------------------------------------f---
-----------------------q---------------------------------------------------------BBBBBBBB---BBBq--------------Q-----------BBB----BqqB--------------------------------------------------------XX--------f---
--------------------------------------------------------------------------------------------------------------------------------------------------------------------------------------------XXX--------f---
--------------------------------------------------------------------------------G----------------------------------------------------------------------------------------------------------XXXX--------f---
-----------------------------------------------------------------I------------------------------------------------------------------------------------------------------------------------XXXXX--------f---
-----------------q---BQBqB---------------------<>---------<>------------------BqB--------------B-----BB----q--q--q-----B----------BB------X--X----------XX--X------------BBqB------------XXXXXX--------f---
---------------------------------------<>------[]---------[]-----------------------------------------------------------------------------XX--XX--------XXX--XX--------------------------XXXXXXX--------f---
-----------------------------<>--------[]------[]---------[]----------------------------------------------------------------------------XXX--XXX------XXXX--XXX-----<>--------------<>-XXXXXXXX--------f---
----P-----------------G------[]--------[]-G----[]-----G-G-[]------------------------------------G-G--------------------------GG-G-G----XXXX--XXXX----XXXXX--XXXX----[]---------GG---[]XXXXXXXXX--------X---
XXXXXXXXXXXXXXXXXXXXXXXXXXXXXXXXXXXXXXXXXXXXXXXXXXXXXXXXXXXXXXXXXXXXXX--XXXXXXXXXXXXXXX---XXXXXXXXXXXXXXXXXXXXXXXXXXXXXXXXXXXXXXXXXXXXXXXXXXXXXXXXXXXXXXXX--XXXXXXXXXXXXXXXXXXXXXXXXXXXXXXXXXXXXXXXXXXXXXXX